${AnsiColor.BRIGHT_GREEN}
                                                                                                              
         ,----,                                                                                               
       .'   .`|  ,--,     ,--,      ,---,.                ,----..        ,----..        ,----..         ,---, 
    .'   .'   ;  |'. \   / .`|    ,'  .' |               /   /   \      /   /   \      /   /   \     ,`--.' | 
  ,---, '    .'  ; \ `\ /' / ;  ,---.'   |     ,---,.   /   .     :    /   .     :    /   .     :   /    /  : 
  |   :     ./   `. \  /  / .'  |   |   .'   ,'  .' |  .   /   ;.  \  .   /   ;.  \  .   /   ;.  \ :    |.' ' 
  ;   | .'  /     \  \/  / ./   :   :  :   ,---.'   , .   ;   /  ` ; .   ;   /  ` ; .   ;   /  ` ; `----':  | 
  `---' /  ;       \  \.'  /    :   |  |-, |   |    | ;   |  ; \ ; | ;   |  ; \ ; | ;   |  ; \ ; |    '   ' ; 
    /  ;  /         \  ;  ;     |   :  ;/| :   :  .'  |   :  | ; | ' |   :  | ; | ' |   :  | ; | '    |   | | 
   ;  /  /--,      / \  \  \    |   |   .' :   |.'    .   |  ' ' ' : .   |  ' ' ' : .   |  ' ' ' :    '   : ; 
  /  /  / .`|     ;  /\  \  \   '   :  '   `---'      '   ;  \; /  | '   ;  \; /  | '   ;  \; /  |    |   | ' 
./__;       :   ./__;  \  ;  \  |   |  |               \   \  ',  /   \   \  ',  /   \   \  ',  /     '   : | 
|   :     .'    |   : / \  \  ; |   :  \                ;   :    /     ;   :    /     ;   :    /      ;   |.' 
;   |  .'       ;   |/   \  ' | |   | ,'                 \   \ .'       \   \ .'       \   \ .'       '---'   
`---'           `---'     `--`  `----'                    `---`          `---`          `---`                 

